IdLandkreis,Bundesland,Landkreis,Fläche,Bevölkerung,Männlich,Weiblich,proKM
1001,Schleswig-Holstein,Flensburg,53.02,90164,44904,45260,1701
1002,Schleswig-Holstein,Kiel,118.65,246794,120198,126596,2080
1003,Schleswig-Holstein,Lübeck,214.19,216530,104032,112498,1011
1004,Schleswig-Holstein,Neumünster,71.66,80196,39723,40473,1119
1051,Schleswig-Holstein,Dithmarschen,1428.17,133193,65718,67475,93
1053,Schleswig-Holstein,Herzogtum Lauenburg,1263.07,198019,97165,100854,157
1054,Schleswig-Holstein,Nordfriesland,2083.55,165951,81286,84665,80
1055,Schleswig-Holstein,Ostholstein,1393.02,200539,96689,103850,144
1056,Schleswig-Holstein,Pinneberg,664.25,316103,155123,160980,476
1057,Schleswig-Holstein,Plön,1083.56,128686,62487,66199,119
1058,Schleswig-Holstein,Rendsburg-Eckernförde,2189.79,274098,134970,139128,125
1059,Schleswig-Holstein,Schleswig-Flensburg,2071.28,201156,99557,101599,97
1060,Schleswig-Holstein,Segeberg,1344.47,277175,137054,140121,206
1061,Schleswig-Holstein,Steinburg,1055.7,131013,64747,66266,124
1062,Schleswig-Holstein,Stormarn,766.17,244156,119230,124926,319
2000,Hamburg,Hamburg,755.09,1847253,903974,943279,2446
3101,Niedersachsen,Braunschweig,192.7,249406,123630,125776,1294
3102,Niedersachsen,Salzgitter,224.49,104291,51831,52460,465
3103,Niedersachsen,Wolfsburg,204.61,124371,61973,62398,608
3151,Niedersachsen,Gifhorn,1567.55,176523,88295,88228,113
3153,Niedersachsen,Goslar,966.72,136292,67599,68693,141
3154,Niedersachsen,Helmstedt,676.15,91297,45273,46024,135
3155,Niedersachsen,Northeim,1268.76,132285,65290,66995,104
3157,Niedersachsen,Peine,536.5,134801,66753,68048,251
3158,Niedersachsen,Wolfenbüttel,724.3,119622,59212,60410,165
3159,Niedersachsen,Göttingen,1755.42,326041,160023,166018,186
3241,Niedersachsen,Hannover,2297.13,1157115,566626,590489,504
3251,Niedersachsen,Diepholz,1991.01,217089,107876,109213,109
3252,Niedersachsen,Hameln-Pyrmont,797.54,148549,71880,76669,186
3254,Niedersachsen,Hildesheim,1208.34,275817,134547,141270,228
3255,Niedersachsen,Holzminden,694.27,70458,34911,35547,101
3256,Niedersachsen,Nienburg (Weser),1400.82,121390,60299,61091,87
3257,Niedersachsen,Schaumburg,675.67,157820,77266,80554,234
3351,Niedersachsen,Celle,1550.82,179011,88101,90910,115
3352,Niedersachsen,Cuxhaven,2058.96,198038,96867,101171,96
3353,Niedersachsen,Harburg,1248.45,254431,125373,129058,204
3354,Niedersachsen,Lüchow-Dannenberg,1227.33,48412,23783,24629,39
3355,Niedersachsen,Lüneburg,1327.8,184139,89803,94336,139
3356,Niedersachsen,Osterholz,652.67,113928,55926,58002,175
3357,Niedersachsen,Rotenburg (Wümme),2074.78,163782,82317,81465,79
3358,Niedersachsen,Heidekreis,1881.45,140673,70251,70422,75
3359,Niedersachsen,Stade,1267.38,204512,101831,102681,161
3360,Niedersachsen,Uelzen,1462.59,92389,45137,47252,63
3361,Niedersachsen,Verden,789.33,137133,67299,69834,174
3401,Niedersachsen,Delmenhorst,62.45,77559,38313,39246,1242
3402,Niedersachsen,Emden,112.34,49913,24884,25029,444
3403,Niedersachsen,Oldenburg,103.09,169077,81019,88058,1640
3404,Niedersachsen,Osnabrück,119.8,165251,79881,85370,1379
3405,Niedersachsen,Wilhelmshaven,107.07,76089,37444,38645,711
3451,Niedersachsen,Ammerland,730.64,124859,60906,63953,171
3452,Niedersachsen,Aurich,1287.35,189694,93316,96378,147
3453,Niedersachsen,Cloppenburg,1420.34,170682,86436,84246,120
3454,Niedersachsen,Emsland,2883.67,326954,166332,160622,113
3455,Niedersachsen,Friesland,609.53,98704,48179,50525,162
3456,Niedersachsen,Grafschaft Bentheim,981.79,137162,68658,68504,140
3457,Niedersachsen,Leer,1085.72,170756,85211,85545,157
3458,Niedersachsen,Oldenburg,1064.83,130890,64873,66017,123
3459,Niedersachsen,Osnabrück,2121.81,358080,177737,180343,169
3460,Niedersachsen,Vechta,814.2,142814,72095,70719,175
3461,Niedersachsen,Wesermarsch,824.78,88583,44415,44168,107
3462,Niedersachsen,Wittmund,656.86,56926,27900,29026,87
4011,Bremen,Bremen,317.84,567559,280381,287178,1786
4012,Bremen,Bremerhaven,101.53,113643,56620,57023,1119
5111,Nordrhein-Westfalen,Düsseldorf,217.41,621877,300507,321370,2860
5112,Nordrhein-Westfalen,Duisburg,232.8,498686,246860,251826,2142
5113,Nordrhein-Westfalen,Essen,210.34,582760,282869,299891,2771
5114,Nordrhein-Westfalen,Krefeld,137.78,227417,111015,116402,1651
5116,Nordrhein-Westfalen,Mönchengladbach,170.47,261034,128467,132567,1531
5117,Nordrhein-Westfalen,Mülheim a.d.Ruhr,91.28,170632,82242,88390,1869
5119,Nordrhein-Westfalen,Oberhausen,77.09,210764,103569,107195,2734
5120,Nordrhein-Westfalen,Remscheid,74.52,111338,54888,56450,1494
5122,Nordrhein-Westfalen,Solingen,89.54,159245,77306,81939,1778
5124,Nordrhein-Westfalen,Wuppertal,168.39,355100,174133,180967,2109
5154,Nordrhein-Westfalen,Kleve,1232.99,312465,155462,157003,253
5158,Nordrhein-Westfalen,Mettmann,407.22,485570,234628,250942,1192
5162,Nordrhein-Westfalen,Rhein-Kreis Neuss,576.42,451730,219545,232185,784
5166,Nordrhein-Westfalen,Viersen,563.28,298863,145826,153037,531
5170,Nordrhein-Westfalen,Wesel,1042.79,459976,223956,236020,441
5314,Nordrhein-Westfalen,Bonn,141.06,329673,157533,172140,2337
5315,Nordrhein-Westfalen,Köln,405.01,1087863,530473,557390,2686
5316,Nordrhein-Westfalen,Leverkusen,78.87,163729,79776,83953,2076
5334,Nordrhein-Westfalen,Aachen,706.91,557026,281467,275559,788
5358,Nordrhein-Westfalen,Düren,941.49,264638,131365,133273,281
5362,Nordrhein-Westfalen,Rhein-Erft-Kreis,704.71,470615,230055,240560,668
5366,Nordrhein-Westfalen,Euskirchen,1248.73,193656,95537,98119,155
5370,Nordrhein-Westfalen,Heinsberg,627.91,255555,126506,129049,407
5374,Nordrhein-Westfalen,Oberbergischer Kreis,918.85,272057,133842,138215,296
5378,Nordrhein-Westfalen,Rheinisch-Bergischer Kreis,437.32,283271,137356,145915,648
5382,Nordrhein-Westfalen,Rhein-Sieg-Kreis,1153.21,600764,294400,306364,521
5512,Nordrhein-Westfalen,Bottrop,100.61,117565,57188,60377,1169
5513,Nordrhein-Westfalen,Gelsenkirchen,104.94,259645,129032,130613,2474
5515,Nordrhein-Westfalen,Münster,303.28,315293,151230,164063,1040
5554,Nordrhein-Westfalen,Borken,1420.98,371339,185565,185774,261
5558,Nordrhein-Westfalen,Coesfeld,1112.04,220586,108836,111750,198
5562,Nordrhein-Westfalen,Recklinghausen,761.31,614137,299253,314884,807
5566,Nordrhein-Westfalen,Steinfurt,1795.75,448220,222878,225342,250
5570,Nordrhein-Westfalen,Warendorf,1319.42,277840,137208,140632,211
5711,Nordrhein-Westfalen,Bielefeld,258.83,334195,161093,173102,1291
5754,Nordrhein-Westfalen,Gütersloh,969.21,364938,182215,182723,377
5758,Nordrhein-Westfalen,Herford,450.4,250578,123033,127545,556
5762,Nordrhein-Westfalen,Höxter,1201.42,140251,69864,70387,117
5766,Nordrhein-Westfalen,Lippe,1246.22,347514,170528,176986,279
5770,Nordrhein-Westfalen,Minden-Lübbecke,1152.41,310409,153244,157165,269
5774,Nordrhein-Westfalen,Paderborn,1246.8,307839,154132,153707,247
5911,Nordrhein-Westfalen,Bochum,145.66,365587,178131,187456,2510
5913,Nordrhein-Westfalen,Dortmund,280.71,588250,289339,298911,2096
5914,Nordrhein-Westfalen,Hagen,160.45,188686,92214,96472,1176
5915,Nordrhein-Westfalen,Hamm,226.44,179916,88554,91362,795
5916,Nordrhein-Westfalen,Herne,51.42,156449,76795,79654,3043
5954,Nordrhein-Westfalen,Ennepe-Ruhr-Kreis,409.64,324106,157395,166711,791
5958,Nordrhein-Westfalen,Hochsauerlandkreis,1960.17,259777,129719,130058,133
5962,Nordrhein-Westfalen,Märkischer Kreis,1061.07,410222,201975,208247,387
5966,Nordrhein-Westfalen,Olpe,712.14,133955,67146,66809,188
5970,Nordrhein-Westfalen,Siegen-Wittgenstein,1132.89,276944,137591,139353,244
5974,Nordrhein-Westfalen,Soest,1328.63,301785,149882,151903,227
5978,Nordrhein-Westfalen,Unna,543.21,394891,192351,202540,727
6411,Hessen,Darmstadt,122.07,159878,81439,78439,1310
6412,Hessen,Frankfurt am Main,248.31,763380,376802,386578,3074
6413,Hessen,Offenbach,44.88,130280,64603,65677,2903
6414,Hessen,Wiesbaden,203.87,278474,133104,145370,1366
6431,Hessen,Bergstraße,719.47,270340,133608,136732,376
6432,Hessen,Darmstadt-Dieburg,658.64,297844,148046,149798,452
6433,Hessen,Groß-Gerau,453.03,275726,138083,137643,609
6434,Hessen,Hochtaunuskreis,481.84,236914,115143,121771,492
6435,Hessen,Main-Kinzig-Kreis,1397.32,420552,207433,213119,301
6436,Hessen,Main-Taunus-Kreis,222.53,238558,116820,121738,1072
6437,Hessen,Odenwaldkreis,623.97,96703,47855,48848,155
6438,Hessen,Offenbach,356.24,355813,175379,180434,999
6439,Hessen,Rheingau-Taunus-Kreis,811.41,187160,92025,95135,231
6440,Hessen,Wetteraukreis,1100.66,308339,152469,155870,280
6531,Hessen,Gießen,854.56,270688,133185,137503,317
6532,Hessen,Lahn-Dill-Kreis,1066.3,253319,124903,128416,238
6533,Hessen,Limburg-Weilburg,738.44,171912,85419,86493,233
6534,Hessen,Marburg-Biedenkopf,1262.37,247084,121619,125465,196
6535,Hessen,Vogelsbergkreis,1458.91,105643,52861,52782,72
6611,Hessen,Kassel,106.8,202137,99319,102818,1893
6631,Hessen,Fulda,1380.41,223145,110782,112363,162
6632,Hessen,Hersfeld-Rotenburg,1097.75,120719,60512,60207,110
6633,Hessen,Kassel,1293.31,236764,116153,120611,183
6634,Hessen,Schwalm-Eder-Kreis,1539.01,179673,89941,89732,117
6635,Hessen,Waldeck-Frankenberg,1848.7,156406,77901,78505,85
6636,Hessen,Werra-Meißner-Kreis,1024.83,100629,49856,50773,98
7111,Rheinland-Pfalz,Koblenz,105.25,114052,55754,58298,1084
7131,Rheinland-Pfalz,Ahrweiler,787.02,130086,64033,66053,165
7132,Rheinland-Pfalz,Altenkirchen,642.38,128805,63882,64923,201
7133,Rheinland-Pfalz,Bad Kreuznach,863.89,158345,77387,80958,183
7134,Rheinland-Pfalz,Birkenfeld,776.83,80951,40111,40840,104
7135,Rheinland-Pfalz,Cochem-Zell,692.43,61375,30760,30615,89
7137,Rheinland-Pfalz,Mayen-Koblenz,817.73,214434,105889,108545,262
7138,Rheinland-Pfalz,Neuwied,627.05,182811,90104,92707,292
7140,Rheinland-Pfalz,Rhein-Hunsrück-Kreis,991.06,103163,51379,51784,104
7141,Rheinland-Pfalz,Rhein-Lahn-Kreis,782.24,122297,60517,61780,156
7143,Rheinland-Pfalz,Westerwaldkreis,989.04,201904,100239,101665,204
7211,Rheinland-Pfalz,Trier,117.06,111528,55053,56475,953
7231,Rheinland-Pfalz,Bernkastel-Wittlich,1167.92,112483,56323,56160,96
7232,Rheinland-Pfalz,Bitburg-Prüm,1626.95,99058,49869,49189,61
7233,Rheinland-Pfalz,Vulkaneifel,911.64,60646,30441,30205,67
7235,Rheinland-Pfalz,Trier-Saarburg,1102.26,149398,73878,75520,136
7311,Rheinland-Pfalz,Frankenthal,43.88,48762,23703,25059,1111
7312,Rheinland-Pfalz,Kaiserslautern,139.7,100030,50503,49527,716
7313,Rheinland-Pfalz,Landau i.d.Pfalz,82.94,46881,22274,24607,565
7314,Rheinland-Pfalz,Ludwigshafen,77.43,172253,86486,85767,2225
7315,Rheinland-Pfalz,Mainz,97.73,218578,106387,112191,2237
7316,Rheinland-Pfalz,Neustadt a.d.Weinstraße,117.09,53264,26025,27239,455
7317,Rheinland-Pfalz,Pirmasens,61.35,40231,19685,20546,656
7318,Rheinland-Pfalz,Speyer,42.71,50561,24455,26106,1184
7319,Rheinland-Pfalz,Worms,108.73,83542,41238,42304,768
7320,Rheinland-Pfalz,Zweibrücken,70.64,34193,16943,17250,484
7331,Rheinland-Pfalz,Alzey-Worms,588.07,129687,64482,65205,221
7332,Rheinland-Pfalz,Bad Dürkheim,594.64,132671,64871,67800,223
7333,Rheinland-Pfalz,Donnersbergkreis,645.41,75325,37331,37994,117
7334,Rheinland-Pfalz,Germersheim,463.32,129013,64277,64736,278
7335,Rheinland-Pfalz,Kaiserslautern,640,105979,52078,53901,166
7336,Rheinland-Pfalz,Kusel,573.61,70219,34874,35345,122
7337,Rheinland-Pfalz,Südliche Weinstraße,639.93,110521,54419,56102,173
7338,Rheinland-Pfalz,Rhein-Pfalz-Kreis,304.99,154609,76324,78285,507
7339,Rheinland-Pfalz,Mainz-Bingen,605.36,211417,104277,107140,349
7340,Rheinland-Pfalz,Südwestpfalz,953.53,94831,46753,48078,99
8111,Baden-Württemberg,Stuttgart,207.33,635911,317794,318117,3067
8115,Baden-Württemberg,Böblingen,617.76,392807,195497,197310,636
8116,Baden-Württemberg,Esslingen,641.28,535024,267334,267690,834
8117,Baden-Württemberg,Göppingen,642.34,258145,128649,129496,402
8118,Baden-Württemberg,Ludwigsburg,686.77,545423,270799,274624,794
8119,Baden-Württemberg,Rems-Murr-Kreis,858.08,427248,211395,215853,498
8121,Baden-Württemberg,Heilbronn,99.9,126592,63802,62790,1267
8125,Baden-Württemberg,Heilbronn,1099.91,344456,172994,171462,313
8126,Baden-Württemberg,Hohenlohekreis,776.76,112655,56872,55783,145
8127,Baden-Württemberg,Schwäbisch Hall,1484.07,196761,98720,98041,133
8128,Baden-Württemberg,Main-Tauber-Kreis,1304.12,132399,65992,66407,102
8135,Baden-Württemberg,Heidenheim,627.13,132777,66089,66688,212
8136,Baden-Württemberg,Ostalbkreis,1511.39,314025,156464,157561,208
8211,Baden-Württemberg,Baden-Baden,140.19,55185,26522,28663,394
8212,Baden-Württemberg,Karlsruhe,173.42,312060,159887,152173,1799
8215,Baden-Württemberg,Karlsruhe,1084.98,445101,221685,223416,410
8216,Baden-Württemberg,Rastatt,738.43,231420,114941,116479,313
8221,Baden-Württemberg,Heidelberg,108.83,161485,77638,83847,1484
8222,Baden-Württemberg,Mannheim,144.97,310658,155007,155651,2143
8225,Baden-Württemberg,Neckar-Odenwald-Kreis,1125.95,143633,72186,71447,128
8226,Baden-Württemberg,Rhein-Neckar-Kreis,1061.55,548355,269715,278640,517
8231,Baden-Württemberg,Pforzheim,97.99,125957,61998,63959,1285
8235,Baden-Württemberg,Calw,797.29,159201,79850,79351,200
8236,Baden-Württemberg,Enzkreis,573.6,199556,99072,100484,348
8237,Baden-Württemberg,Freudenstadt,870.4,118243,59082,59161,136
8311,Baden-Württemberg,Freiburg i.Breisgau,153.04,231195,110333,120862,1511
8315,Baden-Württemberg,Breisgau-Hochschwarzwald,1378.32,263601,129954,133647,191
8316,Baden-Württemberg,Emmendingen,679.8,166408,82244,84164,245
8317,Baden-Württemberg,Ortenaukreis,1860.29,430953,214820,216133,232
8325,Baden-Württemberg,Rottweil,769.42,139878,70004,69874,182
8326,Baden-Württemberg,Schwarzwald-Baar-Kreis,1025.34,212506,105394,107112,207
8327,Baden-Württemberg,Tuttlingen,734.38,140766,70847,69919,192
8335,Baden-Württemberg,Konstanz,817.98,286305,139337,146968,350
8336,Baden-Württemberg,Lörrach,806.67,228736,112047,116689,284
8337,Baden-Württemberg,Waldshut,1131.14,171003,84828,86175,151
8415,Baden-Württemberg,Reutlingen,1092.48,287034,142281,144753,263
8416,Baden-Württemberg,Tübingen,519.11,228678,111504,117174,441
8417,Baden-Württemberg,Zollernalbkreis,917.58,189363,93921,95442,206
8421,Baden-Württemberg,Ulm,118.68,126790,62913,63877,1068
8425,Baden-Württemberg,Alb-Donau-Kreis,1358.54,197076,99480,97596,145
8426,Baden-Württemberg,Biberach,1409.52,201282,101390,99892,143
8435,Baden-Württemberg,Bodenseekreis,664.77,217470,107252,110218,327
8436,Baden-Württemberg,Ravensburg,1632.08,285424,142334,143090,175
8437,Baden-Württemberg,Sigmaringen,1204.23,130849,65573,65276,109
9161,Bayern,Ingolstadt,133.35,137392,69471,67921,1030
9162,Bayern,München,310.7,1484226,723663,760563,4777
9163,Bayern,Rosenheim,37.22,63551,31357,32194,1707
9171,Bayern,Altötting,569.28,111516,55205,56311,196
9172,Bayern,Berchtesgadener Land,839.82,105929,52153,53776,126
9173,Bayern,Bad Tölz-Wolfratshausen,1110.67,127917,63164,64753,115
9174,Bayern,Dachau,579.16,154899,77524,77375,267
9175,Bayern,Ebersberg,549.39,143649,71806,71843,261
9176,Bayern,Eichstätt,1213.85,132881,67518,65363,109
9177,Bayern,Erding,870.74,138182,69629,68553,159
9178,Bayern,Freising,799.85,180007,92107,87900,225
9179,Bayern,Fürstenfeldbruck,434.8,219311,107802,111509,504
9180,Bayern,Garmisch-Partenkirchen,1012.17,88424,42916,45508,87
9181,Bayern,Landsberg a.Lech,804.36,120302,60066,60236,150
9182,Bayern,Miesbach,866.21,100010,48999,51011,115
9183,Bayern,Mühldorf a.Inn,805.33,115872,58718,57154,144
9184,Bayern,München,664.25,350473,174436,176037,528
9185,Bayern,Neuburg-Schrobenhausen,739.71,97303,48931,48372,132
9186,Bayern,Pfaffenhofen a.d.Ilm,761.05,128227,65167,63060,168
9187,Bayern,Rosenheim,1439.44,261330,129399,131931,182
9188,Bayern,Starnberg,487.71,136667,66265,70402,280
9189,Bayern,Traunstein,1533.76,177319,87614,89705,116
9190,Bayern,Weilheim-Schongau,966.28,135478,67242,68236,140
9261,Bayern,Landshut,65.83,73411,35952,37459,1115
9262,Bayern,Passau,69.56,52803,25613,27190,759
9263,Bayern,Straubing,67.59,47791,24088,23703,707
9271,Bayern,Deggendorf,861.17,119478,59650,59828,139
9272,Bayern,Freyung-Grafenau,983.85,78362,39063,39299,80
9273,Bayern,Kelheim,1065.13,123058,62512,60546,116
9274,Bayern,Landshut,1347.55,159895,80913,78982,119
9275,Bayern,Passau,1530.09,192656,95727,96929,126
9276,Bayern,Regen,974.78,77410,38619,38791,79
9277,Bayern,Rottal-Inn,1281.2,121502,60920,60582,95
9278,Bayern,Straubing-Bogen,1201.61,101120,50763,50357,84
9279,Bayern,Dingolfing-Landau,877.58,96683,49580,47103,110
9361,Bayern,Amberg,50.13,42207,20816,21391,842
9362,Bayern,Regensburg,80.86,153094,74316,78778,1893
9363,Bayern,Weiden i.d.OPf.,70.57,42743,20652,22091,606
9371,Bayern,Amberg-Sulzbach,1255.86,103049,51634,51415,82
9372,Bayern,Cham,1526.82,127998,64289,63709,84
9373,Bayern,Neumarkt i.d.OPf.,1343.96,134573,68058,66515,100
9374,Bayern,Neustadt a.d.Waldnaab,1427.69,94450,47061,47389,66
9375,Bayern,Regensburg,1391.65,194070,97185,96885,139
9376,Bayern,Schwandorf,1458.34,147872,74315,73557,101
9377,Bayern,Tirschenreuth,1084.25,72046,35891,36155,66
9461,Bayern,Bamberg,54.62,77373,37296,40077,1417
9462,Bayern,Bayreuth,66.89,74783,36539,38244,1118
9463,Bayern,Coburg,48.29,41072,20042,21030,851
9464,Bayern,Hof,58.02,45825,22095,23730,790
9471,Bayern,Bamberg,1167.79,147163,73740,73423,126
9472,Bayern,Bayreuth,1273.62,103664,51361,52303,81
9473,Bayern,Coburg,590.42,86747,42836,43911,147
9474,Bayern,Forchheim,642.82,116203,57771,58432,181
9475,Bayern,Hof,892.52,94801,46459,48342,106
9476,Bayern,Kronach,651.49,66743,32987,33756,102
9477,Bayern,Kulmbach,658.33,71566,35244,36322,109
9478,Bayern,Lichtenfels,519.94,66776,32965,33811,128
9479,Bayern,Wunsiedel i.Fichtelgebirge,606.37,72655,35446,37209,120
9561,Bayern,Ansbach,99.91,41798,20022,21776,418
9562,Bayern,Erlangen,76.96,112528,56013,56515,1462
9563,Bayern,Fürth,63.35,128497,63051,65446,2028
9564,Bayern,Nürnberg,186.45,518370,253135,265235,2780
9565,Bayern,Schwabach,40.8,40981,20068,20913,1004
9571,Bayern,Ansbach,1971.33,184591,92836,91755,94
9572,Bayern,Erlangen-Höchstadt,564.55,137262,68245,69017,243
9573,Bayern,Fürth,307.44,117853,57200,60653,383
9574,Bayern,Nürnberger Land,799.52,170792,84197,86595,214
9575,Bayern,Neustadt a.d.Aisch-Bad Windsheim,1267.44,101014,50621,50393,80
9576,Bayern,Roth,895.16,126749,62952,63797,142
9577,Bayern,Weißenburg-Gunzenhausen,970.78,94734,47305,47429,98
9661,Bayern,Aschaffenburg,62.45,71002,34641,36361,1137
9662,Bayern,Schweinfurt,35.7,53426,26169,27257,1497
9663,Bayern,Würzburg,87.6,127934,61131,66803,1460
9671,Bayern,Aschaffenburg,698.9,174200,86457,87743,249
9672,Bayern,Bad Kissingen,1136.9,103235,50860,52375,91
9673,Bayern,Rhön-Grabfeld,1021.68,79635,39646,39989,78
9674,Bayern,Haßberge,956.19,84384,42309,42075,88
9675,Bayern,Kitzingen,684.14,91155,45862,45293,133
9676,Bayern,Miltenberg,715.58,128743,64105,64638,180
9677,Bayern,Main-Spessart,1321.2,126158,62951,63207,95
9678,Bayern,Schweinfurt,841.39,115445,58014,57431,137
9679,Bayern,Würzburg,968.35,162302,80732,81570,168
9761,Bayern,Augsburg,146.86,296582,146222,150360,2019
9762,Bayern,Kaufbeuren,40.02,44398,21872,22526,1109
9763,Bayern,Kempten,63.28,69151,34219,34932,1093
9764,Bayern,Memmingen,70.11,44100,21892,22208,629
9771,Bayern,Aichach-Friedberg,780.23,134655,67161,67494,173
9772,Bayern,Augsburg,1070.63,253468,125761,127707,237
9773,Bayern,Dillingen a.d.Donau,792.23,96562,48441,48121,122
9774,Bayern,Günzburg,762.4,127027,64288,62739,167
9775,Bayern,Neu-Ulm,515.84,175204,86839,88365,340
9776,Bayern,Lindau,323.39,81981,40438,41543,254
9777,Bayern,Ostallgäu,1394.43,141182,70507,70675,101
9778,Bayern,Unterallgäu,1229.57,145341,73229,72112,118
9779,Bayern,Donau-Ries,1274.58,133783,67860,65923,105
9780,Bayern,Oberallgäu,1527.96,156008,76890,79118,102
10041,Saarland,Stadtverband Saarbrücken,410.95,328714,161617,167097,800
10042,Saarland,Merzig-Wadern,556.66,103243,51032,52211,185
10043,Saarland,Neunkirchen,249.8,131408,64540,66868,526
10044,Saarland,Saarlouis,459.35,194319,95138,99181,423
10045,Saarland,Saarpfalz-Kreis,418.28,142196,69120,73076,340
10046,Saarland,Sankt Wendel,476.07,87007,42972,44035,183
11001,Berlin,Berlin Mitte,39.4,385748,189788,195960,9791
11002,Berlin,Berlin Friedrichshain-Kreuzberg,20.04,290386,142870,147516,14490
11003,Berlin,Berlin Pankow,103.22,409335,201393,207942,3966
11004,Berlin,Berlin Charlottenburg-Wilmersdorf,64.69,343592,169047,174545,5311
11005,Berlin,Berlin Spandau,91.88,245197,120637,124560,2669
11006,Berlin,Berlin Steglitz-Zehlendorf,102.56,310071,152555,157516,3023
11007,Berlin,Berlin Tempelhof-Schöneberg,53.05,350984,172684,178300,6616
11008,Berlin,Berlin Neukölln,44.93,329917,162319,167598,7343
11009,Berlin,Berlin Treptow-Köpenick,167.73,273689,134655,139034,1632
11010,Berlin,Berlin Marzahn-Hellersdorf,61.82,269967,132824,137143,4367
11011,Berlin,Berlin Lichtenberg,52.12,294201,144747,149454,5645
11012,Berlin,Berlin Reinickendorf,89.32,266408,131073,135335,2983
12051,Brandenburg,Brandenburg a.d.Havel,229.72,72184,35577,36607,314
12052,Brandenburg,Cottbus,165.62,99678,48816,50862,602
12053,Brandenburg,Frankfurt (Oder),147.85,57751,28099,29652,391
12054,Brandenburg,Potsdam,188.24,180334,87158,93176,958
12060,Brandenburg,Barnim,1479.58,185244,91812,93432,125
12061,Brandenburg,Dahme-Spreewald,2274.5,170791,84806,85985,75
12062,Brandenburg,Elbe-Elster,1899.19,101827,50472,51355,54
12063,Brandenburg,Havelland,1727.31,162996,80547,82449,94
12064,Brandenburg,Märkisch-Oderland,2158.65,195751,97086,98665,91
12065,Brandenburg,Oberhavel,1808.18,212914,104949,107965,118
12066,Brandenburg,Oberspreewald-Lausitz,1223.48,109371,53724,55647,89
12067,Brandenburg,Oder-Spree,2256.75,178803,87616,91187,79
12068,Brandenburg,Ostprignitz-Ruppin,2526.56,98861,49144,49717,39
12069,Brandenburg,Potsdam-Mittelmark,2592.02,216566,107234,109332,84
12070,Brandenburg,Prignitz,2138.54,76158,37801,38357,36
12071,Brandenburg,Spree-Neiße,1656.98,113720,55879,57841,69
12072,Brandenburg,Teltow-Fläming,2104.21,169997,84796,85201,81
12073,Brandenburg,Uckermark,3077.03,118947,58415,60532,39
13003,Mecklenburg-Vorpommern,Rostock,181.36,209191,103101,106090,1153
13004,Mecklenburg-Vorpommern,Schwerin,130.52,95653,45957,49696,733
13071,Mecklenburg-Vorpommern,Mecklenburgische Seenplatte,5495.6,258074,126560,131514,47
13072,Mecklenburg-Vorpommern,Rostock,3431.29,215794,107360,108434,63
13073,Mecklenburg-Vorpommern,Vorpommern-Rügen,3216.02,224702,110438,114264,70
13074,Mecklenburg-Vorpommern,Nordwestmecklenburg,2127.08,157322,78294,79028,74
13075,Mecklenburg-Vorpommern,Vorpommern-Greifswald,3945.56,235623,115274,120349,60
13076,Mecklenburg-Vorpommern,Ludwigslust-Parchim,4766.78,211779,105628,106151,44
14511,Sachsen,Chemnitz,221.05,246334,121810,124524,1114
14521,Sachsen,Erzgebirgskreis,1827.91,334948,163885,171063,183
14522,Sachsen,Mittelsachsen,2116.85,304099,151334,152765,144
14523,Sachsen,Vogtlandkreis,1412.42,225997,110269,115728,160
14524,Sachsen,Zwickau,949.78,315002,153663,161339,332
14612,Sachsen,Dresden,328.48,556780,277612,279168,1695
14625,Sachsen,Bautzen,2395.6,299758,148084,151674,125
14626,Sachsen,Görlitz,2111.41,252725,123768,128957,120
14627,Sachsen,Meißen,1454.59,241717,118997,122720,166
14628,Sachsen,Sächsische Schweiz-Osterzgebirge,1654.19,245586,121254,124332,148
14713,Sachsen,Leipzig,297.8,593145,291450,301695,1992
14729,Sachsen,Leipzig,1651.28,258139,126466,131673,156
14730,Sachsen,Nordsachsen,2028.56,197741,98130,99611,97
15001,Sachsen-Anhalt,Dessau-Roßlau,244.71,80103,38894,41209,327
15002,Sachsen-Anhalt,Halle,135.03,238762,115552,123210,1768
15003,Sachsen-Anhalt,Magdeburg,201.01,237565,117391,120174,1182
15081,Sachsen-Anhalt,Altmarkkreis Salzwedel,2293.74,83173,41428,41745,36
15082,Sachsen-Anhalt,Anhalt-Bitterfeld,1453.84,158486,77624,80862,109
15083,Sachsen-Anhalt,Börde,2366.99,170923,85224,85699,72
15084,Sachsen-Anhalt,Burgenlandkreis,1413.95,178846,88658,90188,126
15085,Sachsen-Anhalt,Harz,2104.75,213310,104712,108598,101
15086,Sachsen-Anhalt,Jerichower Land,1577.08,89589,44600,44989,57
15087,Sachsen-Anhalt,Mansfeld-Südharz,1449.01,134942,66285,68657,93
15088,Sachsen-Anhalt,Saalekreis,1434.01,183815,90793,93022,128
15089,Sachsen-Anhalt,Salzlandkreis,1427.5,189125,92363,96762,132
15090,Sachsen-Anhalt,Stendal,2424.11,111190,54869,56321,46
15091,Sachsen-Anhalt,Wittenberg,1930.78,124953,61469,63484,65
16051,Thüringen,Erfurt,269.91,213981,104044,109937,793
16052,Thüringen,Gera,152.18,93125,44945,48180,612
16053,Thüringen,Jena,114.77,111343,55628,55715,970
16054,Thüringen,Suhl,141.62,36789,18009,18780,260
16055,Thüringen,Weimar,84.48,65228,31549,33679,772
16056,Thüringen,Eisenach,104.17,42250,20833,21417,406
16061,Thüringen,Eichsfeld,943.07,100006,50219,49787,106
16062,Thüringen,Nordhausen,713.9,83416,41394,42022,117
16063,Thüringen,Wartburgkreis,1266.96,118974,59573,59401,94
16064,Thüringen,Unstrut-Hainich-Kreis,979.68,102232,50775,51457,104
16065,Thüringen,Kyffhäuserkreis,1037.91,74212,36865,37347,72
16066,Thüringen,Schmalkalden-Meiningen,1251.21,124916,62446,62470,100
16067,Thüringen,Gotha,936.08,134908,67158,67750,144
16068,Thüringen,Sömmerda,806.85,69427,34660,34767,86
16069,Thüringen,Hildburghausen,938.42,63197,31624,31573,67
16070,Thüringen,Ilm-Kreis,805.12,106249,53446,52803,132
16071,Thüringen,Weimarer Land,804.48,82156,40724,41432,102
16072,Thüringen,Sonneberg,460.85,57717,28391,29326,125
16073,Thüringen,Saalfeld-Rudolstadt,1008.79,103199,50838,52361,102
16074,Thüringen,Saale-Holzland-Kreis,815.24,82950,41262,41688,102
16075,Thüringen,Saale-Orla-Kreis,1151.3,80312,39890,40422,70
16076,Thüringen,Greiz,845.98,97398,47921,49477,115
16077,Thüringen,Altenburger Land,569.39,89393,43802,45591,157
